10 10
3 2#     3|
2#    222#|
 #2  2  #2|
##3 #33 23|
322#3233 #|
#3# 3#23# |
2 ## 33## |
   22323#2|
         #|
2   # 2 22|
-----------
