10 10
  332 2 2 |
223223223 |
223 23## 3|
2  3B # 33|
32 2 22 23|
  ## 3 3##|
  #2###2#3|
223  # 333|
2 32 A #2 |
333  2  23|
-----------
