10 10
23 B##3 22|
 2 2# 2322|
333##B 22 |
 33#322222|
33 # 3  2 |
3323232  2|
 32  3G2 A|
 322 3222 |
G#  ### 3A|
2####2 2 2|
-----------
