10 10
  333323  |
3#2##2## 2|
#223#3 32 |
B 3 2 #   |
33232   33|
2332 3#2# |
 22222#33 |
 2 ### 2#3|
323 #3#2#2|
 3# 2322 2|
-----------
