10 10
32#2   323|
33####2332|
 3  #### 3|
 22A###B 2|
33ABG 2  2|
3 2 32 3  |
 #  3#  33|
3###3###2 |
  G3333 3 |
A323322222|
-----------
