10 10
23332 3  #|
2 3232#2 3|
233  22332|
####3#22 3|
#3#2## ## |
#B33#3#   |
   33##3 #|
 3##232 32|
2#232#3#2 |
#3# #2#33#|
-----------
