10 12
33##A 32##B3|
BA #32332#2G|
#22# 22 2# 2|
###3 3232   |
 22233333A33|
 G 332 33233|
3 3 # 3 3#32|
##2 ###22###|
 ## 2 232 23|
 ####23 2B 2|
-------------
