10 10
3##232    |
3# 333 ?3 |
2#   BG3 3|
###33333 2|
3 #3223 ##|
223G222B #|
2##2?3332#|
2#32232233|
?# 2 ? A 2|
2333 22333|
-----------
