10 10
3 2  #323 |
3 3#3#23  |
2#32# 32#2|
2#  33#222|
#22  2A32#|
3 3 3333#2|
 #3  #3# 3|
 2B32 3A3#|
323#2#33 #|
   233 322|
-----------
