10 10
23# ##2 # |
 2##2222#2|
B  22##23 |
 23 #33  3|
223 3 # 2 |
  #22  ##3|
33 3 ## 33|
 ##232 2##|
#  # #3 32|
233##2#233|
-----------
