10 10
3#3 32 32#|
3#3332  ##|
33222 #22 |
22#3# # #3|
33233#3#  |
232 3#22  |
B3 3 2 ###|
  #3  #32 |
##2 23233#|
2332#3# #3|
-----------
