10 10
32  22  22|
33  2 3###|
  3###22##|
322B2 2A##|
3 22 2 2  |
3 3233322 |
33   3 3  |
 2#3  2  A|
2#2322  2#|
 #     ###|
-----------
