10 10
#22333 22 |
2 2####3 #|
2#2#32 #3#|
3##   22 #|
 323   # 3|
 2##22# 33|
3# 2###   |
3 22  3   |
2323B 3#32|
 2222 33##|
-----------
