10 10
? 22 2 2##|
3## 3   #A|
3#? 2G33#3|
2#33###322|
B23 ###222|
 2 3 2# G3|
2? 2A2?   |
2 2B 33###|
33 2222###|
2  3223#  |
-----------
