15 15
111111111111111|
###############|
###############|
###############|
###############|
###############|
###############|
###############|
111111111111111|
111111111111111|
222222222222222|
222222222222222|
333333333333333|
333333333333333|
###############|
----------------
