10 10
2 2 333 22|
3 B#32322A|
3###3 ##3 |
222B333#G3|
2 ?23 ?# 2|
23###  222|
2 #33 G333|
33232A322 |
2? 2 A2223|
32 ? 2333 |
-----------
