10 10
33## 3    |
23#3222   |
3 ## 3 323|
 232322 2 |
 2### 222 |
  222B3  2|
33323  23 |
A 3   23##|
2A 333223#|
 2  33 23#|
-----------
