10 10
G   2 ##33|
  33 ## 22|
23232##3G2|
2A333#2222|
B2 23  ## |
2322223#  |
22    2#3 |
323 ## 223|
3   #23A33|
3 2 #33 2B|
-----------
