10 10
 3#3323#22|
3# B 3# 2 |
 #23 3#32#|
#3#233#32#|
# 2# #23 2|
 2 2232  #|
 2## 323##|
2#2#3# 232|
#22233#233|
 22 32#3 2|
-----------
