10 10
F#2 222  3|
# ##2 32# |
 3##2  2##|
2 #23##23#|
3  #  #333|
#32#2##23 |
2#22 32322|
 3##2   #3|
#2##   #  |
2 3 # 33#S|
-----------
