10 10
2  2323   |
 233 3B A |
3###222322|
3 ###    2|
 332#  23A|
  3333###3|
 ### 223#G|
233#2 # 23|
 2  32###3|
B2    3G23|
-----------
