10 10
 2###2   3|
2 ###3    |
23A # 223 |
# 32  3G2 |
#####3 32 |
 2# 32333B|
32 33 33G2|
 32B23223 |
###322#32 |
#222###3 3|
-----------
