10 10
  23   2 3|
G3232 22##|
 33  2 2#2|
 233#####3|
2332 3# 33|
32 B32   2|
G222  2222|
 3A    2  |
3###A2B333|
2  #2     |
-----------
