10 10
3333  3?B3|
####233##3|
 # #   2# |
 ###2  2#3|
2  A 23  A|
33 3?22 ##|
2323323  #|
?2232 A 2#|
 3?3 G # B|
G2 322 ###|
-----------
