10 10
22 2333 32|
33A 3A 2#3|
2##2 # 2##|
 2##2## 2 |
 233 32   |
 # A2233 3|
3 2#222  B|
333## 23 B|
#33332323#|
32233  ###|
-----------
