10 10
3   2 32##|
2B3 3  2#2|
333    2  |
 3 2 # 3#2|
#2#323232 |
#2#22222#3|
2233##2222|
32332##  #|
    33##2 |
3 #2 2#  #|
-----------
