10 10
 2A333 B23|
222 3 2323|
22A ###3 2|
  222G#3  |
 2 22 ###3|
G## 32  #3|
  # 2###  |
  ####3223|
  322#222 |
 AB   3233|
-----------
