10 10
3##232333 |
33 3 3##3 |
23 #3 2# #|
23####3#3 |
#3#2##3#32|
#23##322##|
  3 2#3322|
23# 2 #32 |
3#2 2    #|
2#2#2#223#|
-----------
