10 10
? A3 AG2##|
 2 22232 #|
2 2?23333#|
 3332###3 |
2 2###2##3|
2 2#2 ### |
2   ? 3B22|
B?3322232 |
33   #A 22|
33G23### 2|
-----------
