10 10
3##B2 2A##|
2#333 3 2#|
2#22A2222#|
3  2222233|
2 32##33 2|
3 ###2 33 |
22#3#2 3  |
###2  2  2|
#233322 2 |
#   2223  |
-----------
