10 10
23A33   2 |
 233 23B2 |
32 2# 2  2|
3  22 33  |
23A32 #22 |
3 #2 #3 3 |
2##3A#3   |
   2##  32|
  2## 333 |
23  32   3|
-----------
