10 10
F   33# # |
2#2#2## 32|
 23  2# #3|
##2 ##2 33|
#3#3 # 2 #|
  #3 3##2#|
232323# #3|
 3#3 22  #|
2 222# #2#|
##3#233 3S|
-----------
