10 10
 232##2## |
2A 3#33# 3|
3 ###A 33 |
  ###B #33|
 2## 23   |
  3##2 2  |
A33#  32  |
22#B333 3 |
232 3  323|
332323  23|
-----------
