10 10
3 22#33#2 |
232##2 #  |
   3# 2#3 |
 223 22#2 |
3 2#33#323|
2##3 #A222|
B2# ##32##|
2  2##333#|
3#3 3#2# #|
#3A# 3 ## |
-----------
